11110111111111111111111111111111111111111111111111111111111111111111111111111111111111111111111111111111111111111111111
11110000000000000000000000000000000000400000000000111111111111111111111111111111111111111111111111111111111111111111111
11111111111111111111111111111111111111111111111100111111111111111111111111111111111111111111111111111111111111111111111
11111111111111111111111111111111111111111111100000000000000000000000000011111111111111111111111111111111111111111111111
11111111111111111111111111111111111111111111100111111111111111111111110000000000000111111111111111111111111111111111111
11112000000000000000000000000000000000000000000111111111111111111111113333333333333111111111111111111111111111111111111
11112000000000000000000000000000000000000000000111111111111111111111113333333333333111111111111111111111111111111111111
11112000000000000000000000000000000000000000000111111111111111111111113333333333333111111111111111111111111111111111111
11112001111111111111111111111111111111111111111111111111111111111111111111111111111111111111111111111111111111111111111
11112001111111111111111111111111111111111111111111111111111111111111111111111111111111111111111111111111111111111111111
11112000000000000000000000000000000000000000000000000000000000000000000000000000000000000000000000000000000000000111111
11111111111111111111111111011111111111111111111111111100111111111111111111111111000111111111111111111111111111000111111
11111111111111111111111111311111111111111111111111111133111111111111111111111111333111111111111111111111111110001111111
11111111111111111111111111111111111111111111111111111111111111111111111111111111111111111111111111111111111100011111111
11111111111111111111111111111111111111111111111111111111111111111111111111111111111111111111111111111111111000111111111
11111111111111111111111111111111111111111111111111111111111111111111111111111111111111111111111111111111110001111111111
11111111111111111111111111111111111111111111111111111111111111111111111111111111111111111111111111111111100011111111111
11111111111111111111111111111111111111111111111111111111111111111111111111111111111111111111111111111111000111111111111
11111111111111111111111111111111111111111111111111111111111111111111111111111111111111111111111111111110001111111111111
11111111111111111111111111111111111111111111111111111111111111111111111111111111110000000000000000000000011111111111111
11111111111111111111111111111111111111111111111111111111111111111111111111111111110011111111111111111111111111111111111
11111111111111111111111111111111111111111111111111111111111111111111111111111111110000000000000000011111111111111111111
11111111111111111111111111111111111111111111111111111111111111111111111111111111111111111111111110011111111111111111111
11111111111111111111111111111111111111111111111111000000000000000000000000000000000000000000000000011111111111111111111
11111111111111111111111111111111111111111111111111001111111111111111111111111111111111111111111111111111111111111111111
11111111111111111111111111111111111111111111100000000000011111111111111111111111111111111111111111111111111111111111111
11111111111111111111111111111111111111111111101111111111011111111111111111111111111111111111111111111111111111111111111
11111111111111111111111111111111111111111111101111111111011111111111111111111111111111111111111111111111111111111111111
11111111111111111111111111111111111111111111100000000000011111111111111111111111111111111111111111111111111111111111111
11111111111111111111111111111111111111111111111111001111111111111111111111111111111111111111111111111111111111111111111
11111111111111111111111111111111111111111111100000000000002111111111111111111111111111111111111111111111111111111111111
11111111111111111111111111111111111111111111000111111111111111111111111111111111111111111111111111111111111111111111111
11111111111111111111111111111111111111111110001111111111111111111111111111111111111111111111111111111111111111111111111
11111111111111111140000000000000000000000000011111111111111111111111111111111111111111111111111111111111111111111111111
11111111111111111111111111111111111111111111111111111111111111111111111111111111111111111111111111111111111111111111111
11111111111111111111111111111111111111111111111111111111111111111111111111111111111111111111111111111111111111111111111
11111111111111111111111111111111111111111111111111111111111111111111111111111111111111111111111111111111111111111111111