0000000000000000000000000000000000000000000000
1111111100000000000000000000000000000000000000
0000000000200000000000000000000000000000000000
0000000000111111000000000000000000000333000000
0000000000000000000000000000000000000333000000
0000000000000000000011111000000000000333000000
0000000000000000000000000000000000000000000000
0000000000000111110000000000000000000000000000
0000000000000000000000000000000000000000000040
0000000000000000000001111111111111111111111111
2222222222222222222222222222222222222222222111