00000000000000000000000000000000000000000000000000000000000000000000000000000000000000000000000000000000000000000000000
11111111000000000000000000000000000003000000000000000000000000000000000000000000000000000000000000000000000000000000000
00000000000000000000000000000000000003000000000000000000000000000000000000000000000000000000000000000000000000000000000
00000000001111110000000000000000000003000000000000000000000000000000000000000000000000000000000000000000000000000000000
00000000000000000000000000000000000003000000000000000000000000000000000000000000000000000000000000000000000000000000000
00000000000000000000000000000000000000000000000000000000000000000000000000000000000000000000000000000000000000000000000
00000000000000000011111111100000000003000000000000000000000000000000000000000000000000000000000000000000000000000000000
00000000000000000000000000000000000000000000000000000000000000000000000000000000000000000000000000000000000000000000000
00000000000000000000000000000111111100000000000000000000000000000000000000000000000000000000000000000000000000000000000
00000000000000000000000000000000000000000000000000000000000000000000000000000000000000000000000000000000000000000000000
00000000000000000000000000000000000000111111111100000000000000000000000000000000000000000000000000000000000000000000000
00000000000000000000000000000000333333000000000000000000000000000000000000000000000000000000000000000000000000000000000
00000000000000000000000000000000333333000022222001110022222003000000000300000000000000000000000000000000000000000000000
00000000000000000000000000000000000000000022222000000022222003300000003300000000000000000000000000000000000000000000000
00000000000000000000000000000000000000000022222001110022222003030000030300000000000000000000000000000000000000000000000
00000000000000000000000000000000000000000022222000000022222003003000300300000000000000000000000000000000000000000000000
00000000000000000000000000000000000000000022222001110022222003000303000300000000000000000000000000000000000000000000000
00000000000000000000000000000000000000000022222000000000222000000000000000000000000000000000000000000000000000000000000
00000000000000000000000000000000000000000022222001110000222000000000001111100000000000000000000000000000000000000000000
00000000000000000000000000000000000000000022222000000000011111100000000111100000000000000000000000000000000000000000000
00000000000000000000000000000000000000000022222000000000000000000000000004100000000000000000000000000000000000000000000
00000000000000000000000000000000000000000022222222222111111111111111111111100000000000000000000000000000000000000000000
00000000000000000000000000000000000000000000000000000000000000000000000000000000000000000000000000000000000000000000000